1152 1088
222222222222222222
211211111111111112
211211111111111112
211222222222211112
211111111111211112
211111111111211112
211111111111211112
211111222222211112
211111211111111112
211111211111111112
211111211111111112
211111211111111112
211111211111111112
211111211111111112
211111211111111112
211111211111111112
222222222222222222