1152 1280
1111j1231g11231231
1g11112311j1231231
111f11295555895831
1j1111e444446744d1
11111g1f11112311j1
1f1111111j11231111
1111c55555558311f1
1j112aaaaaaaa31111
g1112aaaaaaaa3g111
11g12aaaaaaaa311j1
j1112aaaaaaaa31111
111j2aaaaaaaa31g11
1111274444444d1111
1f1123111j11111j11
111123111g11f11111
11g123111111111111
11112311j1111g1111
j111231111f1111111
11f12311g1111j1111
1111231111j1111111